
#     #                             #     #                             
#     # ###### #      #       ####  #  #  #  ####  #####  #      #####  
#     # #      #      #      #    # #  #  # #    # #    # #      #    # 
####### #####  #      #      #    # #  #  # #    # #    # #      #    # 
#     # #      #      #      #    # #  #  # #    # #####  #      #    # 
#     # #      #      #      #    # #  #  # #    # #   #  #      #    # 
#     # ###### ###### ######  ####   ## ##   ####  #    # ###### #####  
